je ne suis pas du même avis -- we are not of the same mind
lirais, lirais, lirait, lirions, liriez, liraient -- lire conditional present
résoudrais, résoudrais, résoudrait, résoudrions, résoudriez, résoudraient -- résoudre conditional present
tonnerre -- thunder
orage -- storm
cachot -- prison
peux puex peut pouvons pouvez peuvent
puis-je
vouloir
pris -- past participle of prendre
er-e,ir-i,re-u -- past participles of regular verbs
suivie -- feminin past participle of suivre
embaucher -- to employ
essuyer -- to wipe
nettoyer -- to clean
passer l'aspirateur -- to vacume
vitrine -— storefront
fais, fais, fait, faisons, faites, font — faire present tense
nager —- to swim
viens, viens, vient, venons, venez, viennent -- venir present tense
commencer un nouveau travail -- to start a new job
venir d -- immediate past
tiens tiens tient tenons tenez tiennent -- tenir, to take, to hold
tenir à -- to be attached to
tenir de -- to take after
il fait doux -- it is mild
il fait grêle -- it's hailing
il fait bruine -- it's drizzling
fair + infinitive -- causitive form
dois dois doit devons devez doivent -- devoir present indicative 
lund mardi mercredi jeudi vendredi samedi dimanche -- days of the week, starting monday

